1111111111111
1000000000001
10C000C000E01
1100001101001
1010010010001
1111111111111