1111111111111
100P000000001
10C000CP00E01
1100001101001
1010010010001
1111111111111