1111111111111
100P000000001
1000000000001
1100001101E01
1010010010001
1111111111111