111111
100C11
10E011
10001P
111111