111111
1E000C1
10000P1
1111111