1111111
1E000C0
10000P0
1111111