1111111
0E000C1
00000P1
0111111