1111111
0E000C0
00000P0
0111110